list of levels from mega new super mario bros tons of wip
liste des niveaux de mega nouveau super mario frère tonnes de wip
choosefirstsavefilezoneroom=zone choix de fichier sauvegarde primaire wip
chooseiconsappearroom=apparition de choix d'icônes wip
chooseiconsappearvalidatecubeappearroom=apparition choix d'icônes apparition cube
validation wip
chooseiconsselectappearroom=apparition icône choisi wip
chooseiconselectmaindevlopperplumberoldroom=icône de galaxyhackernewer ancien
choisi wip
chooseiconsextendroom=prolongation choix d'icônes wip
chooseiconsfinalroom=choix icône salle finale wip
chooseiconsroom=choix d'icônes wip
chooselanguagezonefrenchroom=zone choix de la langue français wip
chooselanguagezoneroom=zone choix de la langue wip
cwfnintendomessageroom=salle message cwf nintendo wip
cwfsasamessageroom=salle message cwf sasa wip
datamessagearoom=salle message données de jeu 0
datamessagebroom=salle message données de jeu 1
loadedaroom=salle chargement 0
loadedbroom=salle chargement 1
loadedcroom=salle chargement 2
loadingaroom=salle patienter 0
loadingbroom=salle patienter 1
loadingcroom=salle patienter 2
movieintrobloodroom=film tâche de sang wip
movieintrobootroom=film grésillements wip
movieintrogreenscreenroom=film écran vert wip
movienightinfreddyfazbearpizzerianightmareappearroom=film apparition de cauchemar
cauchemar fredours ombre freddy cinqs nuits chez freddy 4 wip
movienightinfreddyfazbearpizzerianightmarenightmarefredbearshadowfreddyscreamroom=film peur de cauchemar cauchemar fred
ours ombre freddy wip
movienightinfreddyfazbearpizzeriapowercutroom=film cinqs nuits chez freddy freddy fazbear pizzeria coupure courant wip
movienightinfreedyfazbearpizzerialightoffroom=film cinqs nuits chez freddy freddy fazbear pizzeria lumière éte
inte wip
movienightinfreedyfazbearpizzeriaroom=film cinqs nuits chez freddy freddy fazbear
pizzeria wip
movietitlescreendissapearroom=film disparition écran titre wip
nintendonetworkmessageroom=salle message nintendo network
nintendoswitchonlinemessageroom=salle message nintendo switch online
nintendoswitchonlineplusadditionalpackroom=salle message nintendo switch online+
pack additionel
nintendowificonnectionmessageroom=salle message connexion wi-fi nintendo
sasaconnect42messageroom=salle message sasa connect 42 wip
sasawificonnectionmessageroom=salle message connexion wi-fi sasa wip
sddatamessagearoom=salle message carte SD 0
sddatamessagebroom=salle message carte SD 1
sddatamessagecroom=salle message carte SD 2
spotpassmessageroom=salle message spotpass wip
streetpassmessageroom=salle message streetpassmessageroom wip
titlescreenroom=écran titre wip
wiiconnect24messageroom=salle message wiiconnect24
zpotzassmessageroom=salle message zpotzass wip
ztreetzassmessageroom=salle message ztreetzass wip
others rooms coming really soon
autres salles arrive vraiment bientôt

