list of levels from mega new super mario bros tons of wip
liste des niveaux de mega nouveau super mario frère tonnes de wip
B00tR00m=démarrage jeu salle 2024
Bl00dR00m=sang salle 2024
castleterrace=terasses du château de la princesse fala
ChooseIconSelectMainDevlopperPlumberOldRoom=histoire de galaxyhackernewer ancien balcon de la
maison de galaxyhackernewer ancien (nuit)
chooseiconselectmaindevlopperplumberroom= balcon de la maison de galaxyhackernewer ancien
galaxyhackernewer (jour)
ChooseIconsRoom=salle choix d'icônes wip
ChoosePrimarySaveFileZone=zone choix du fichier de sauvegarde primaire
ConnexonWiFiSasaMessageRoom=salle message connexion wi-fi sasa
CWFSasaMessageRoom=salle message cwf sasa
datamessagearoom=salle message données 0
datamessagebroom=salle message données 1
endingscreendemprototypexxxxxxxxxdevbuild=salle fin construction dévloppement
GreenScreenR00m=salle écran vert
LoadedARoom=chargement 0%
LoadedBRoom=chargement 50 %
LoadedCRoom=chargement 100 %
loadingaroom=patienter 0%
loadingbroom=patienter 50%
loadingcroom=patienter 100%
maindevlopperplumberoldhousegarden=jardin de la maison de galaxyhackernewer ancien
maindevlopperplumberoldhouseinside=intérieur de la maison de galaxyhackernewer ancien
maindevlopperplumberoldhouseoutside=extérieur de la maison de galaxyhackernewer ancien
MovieNightInFreddyFazbearPizzeriaNightmareNightmareFredbearShadowFreddyScreamRoom=salle de lapeursaut jumpscare Cauchemar Cauchemar
FredOurs Ombre Freddy
MovieNightInFreddyFazbearPizzeriaPowerCutRoom=salle pizzeria de freddy fazbear coupure courant
MovieNightInFreddyFazbearPizzeriaLightOffRoom=salle pizzeria de freddy fazbear lumière éteinte
movienightinfreddyfazbearpizzerianightmareappearroom=salle pizzeria de freddy fazbear apparition cauchemar cauchemar fredours
ombre freddy
MovieNightInFreddyFazbearPizzeriaRoom=salle pizzeria de freddy fazbear
NintendoNetworkMessageRoom=salle message Nintendo Network
CWFNintendoMessageRoom=salle message CWF Nintendo
NintendoSwitchOnlineMessageRoom=salle message Nintendo Switch Online
NintendoSwitchOnlinePlusAdditionalPackMessageRoom=salle message Nintendo Switch Online + Pack Additionel
NintendoWiFiConnectionMessageRoom=salle message Connexion Wi-Fi Nintendo
princessfalacastleinside=intérieur du château de la princesse Fala
princessfalacastleinsidedevbuildendroom=fin(Construction Dévloppement mega new super mario bros)
princessfalacastleinsideelevatorroom=château de la princesse Fala (salle des ascenceurs)
princessfalacastleinsideextraliveroom=château de la princesse Fala(salle vie supplémentaire)
princessfalacastleinsidepaintingroom=château de la princesse Fala(salle peinture)
princessfalacastleinsideshinespritesourceroom=château de la princesse Fala(salle source éclat brillant)
princessfalacastleinisdetriplepaintingroom=château de la princesse Fala (salle des peintures triples)
princessfalacastleoutside=château de la princesse Fala
SasaConnect42MessageRoom=salle message sasaconnect42
sddatamessagearoom=salle message carte SD 0
sddatamessagebroom=salle message carte SD 1
sddatamessagecroom=salle message carte SD 2
spaghettikingdom0=royaume spaghetti 0
spaghettikingdom1=royaume spaghetti 1
spaghettikingdom2=royaume spaghetti 2
SpotPassMessageRoom=salle message SpotPass
StreetPassMessageRoom=salle message StreetPass
WiiConnect24MessageRoom=salle message WiiConnect24
ZpotZassMessageRoom=salle message ZpotZass
ZtreetZassMessageRoom=salle message ZtreetZass
chooseiconselectmaindevlopperplumberappearroom=icône choisi galaxyhackernewer wip
chooseiconselectmaindevlopperplumberoldappearroom=icône choisi galaxyhackernewer ancien
ChooseIconSelectMainDevlopperPlumberOldRoom=salle de galaxyhackernewer ancien
chooseiconselectmaindevlopperplumberroom=salle de galaxyhackernewer
ChooseIconsExtendRoom=salle choix d'icône prolongé wip
ChooseIconsFinalRoom=salle choix d'icône finale=salle choix d'icône fin wip
ChooseIconsRoom=salle choix d'icônes 
ChooseLanguageZoneFrenchRoom=salle langue française wip
ChosseLanguageZoneRoom=salle choix langue wip
insideprincessfalacastle=intérieur du château de la princesse fala (hall principal)
insideprincessefalacastlepaintingroom=intérieur du châtaeu de la princesse fala salle peinture
KingBombheiArea=aréne Roi Bob-Omb
LoadingARoom=salle patienter 0%
LoadingBRoom=salle patienter 50%
maindevlopperplumberscenario=scénario de galaxyhackernewer wip
minecraftcavallerhut=cabane de gregory le snapster
MovieIntroBloodRoom=film introduction sang
MovieIntroBootRoom=film introduction grésillement
MovieIntroGreenScreenRoom=film introduction écran vert
MovieTitleScreenDissapearRoom=film disparition écran titre wip
newbombheibattlefeldlevel=la nouvelle guerre des bobs-ombs
newbombheibattlefieldlevelarea1=la nouvelle guerre des bobs-ombs aréne 1
newbombheibattlefieldlevelarea2=la nouvelle guerre des bobs-ombs aréne 2
NewBombheiBattlefieldSecretMountain=montagne secréte de la nouvelle guerre des bobs-ombs
others rooms coming really soon
autres salles arrive vraiment bientôt


