liste sprites= mega nouveau super mario frere/mega new super mario bros 
clasee par ordre alphabetique/classed by alphabetical order
ghnyoutubechannelsoonghngaminglive 26/11/2023 03:19am
ghnyoutubechainebientotghngaminglive 26/11/2023 03:19
BlackBackground=arriere-plan noir
CandySweetWorldBackground==arriere-plan monde bonbon
ChinaFlag=drapeau chinois
Crossemessagename=message croix
CWFNintendoMessagename=message cwf nintendo
datamessagea=message donnees 0
datamessageb=message donnees 1
DefaultFloorBlock=bloc sol par defaut
DesertBackground=arriere-plan desert
DesertHillsBackground=arriere-plan desert et collines
EnglishFlag=drapeau anglais
FireCastleBackground=arriere-plan chateau de feu
FireCastleoutsideBackground=arriere-paln chateau de feu exterieur
FireFieldBackground=arriere-plan champ de feu
ForestBackground=arriere-plan foret
FrenchFlag=drapeau francais
GermanFlag=drapeau allemand
GrandStar=grande etoile
HaloweenWorldBackground=arriere-plan monde Haloween
HathenaBlueBlock=bloc bleu interrupteur casquette
HathenaBlueSwitch=interrupteur casquette bleue
HathenaDisableBlueBlockSwitch=bloc bleu interrupteur casquette désactivé
HathenaGreenBlock=bloc vert interrupteur casquette
HathenaGreenBlockSwitch=interrupteur casquette verte
HathenaMysterySwitch=interrupteur mystere
HathenaRedBlock=bloc rouge interrupteur casquette
HathenaRedBlockSwitch=interrupteur casquette rouge
HathenaYellowBlock=bloc jaune interrupteur casquette
HathenaYellowBlockSwitch=interrupteur casquette jaune
HathenaBlueSwitchFloorBlock=interrupteur casquette bleue (anciennement/oldest)
sol interrupteur casquette bleue (recemment)
HathenaGreenSwitchFloorBlock=sol interrupteur casquette verte
HathenaRedSwitchFloorBlock=sol interrupteur casquette rouge
HauntedForestBackground=arriere-plan foret hantee
HauntedHouseBackground=arriere-plan maison hantee
HillsCloudsBackground=arriere-plan collines et nuages
HillsOceanBackground=arriere-plan collines et ocean
ItalianFlag=drapeau italien
JapanFlag=drapeau japonais
KinokoKingdomCoins=piece d'or du royaume champignon
KittyGeek=tougeek914
KittyGeekBodyA=tougeek914 corps partie 0
KittyGeekBodyB=tougeek914 corps partie 1
KittyGeekBodyC=tougeek914 corps partie finale
KoopaCastleBackground=arriere-plan chateau de bowser
LetterEmessagename=lettre E
LetterNmessagename=lettre N
LetterWmessagename=lettre W
loaded0percentmessagename=chargement 0%
loaded50percentmessagename=chargement 50%
loaded100percentmessagename=chargement 100%
loadedmessagename=chargement
loading0percentmessagename=patienter 0%
loading50percentmessagename=patienter 50%
loading100perecntmessagename=patienter 100%
loading0percentspritecopymessagename=patienter 0% (anciennement/oldest)
loading50percentspritecopymessagename=patienter 50%(anciennement/oldest)
loading100percentspritecopymessagename=patienter 100%(anciennement/oldest)
loadingmessagename=patienter
lodadedmessagename=chargement(anciennement/oldest)
maindevlopperplumber=galaxyhackernewer
maindevlopperplumberbodyA=galaxyhackernewer corps partie 0
maindevlopperplumberbodyB=galaxyhackernewer corps partie 1
maindevlopperplumberbodyC=galaxyhackernewer corps partie finale
maindevlopperplumberfriend=galaxyhacker42
maindevlopperplumberfriendbodyA=galaxyhacker42 corps partie 0
maindevlopperplumberfriendbodyB=galaxyhacker42 corps partie 1
maindevlopperplumberold=galaxyhackernewer ancien
MeadowsBackground=arriere-plan prairie
NintendoNetworkMessageName=message Nintendo Network
NintendoSwitchOnlineMessageName=message Nintendo Switch Online
NintendoSwitchOnlinePlusAdditionalPackMessageName=message Nintendo Switch Online + Pack Aditionel
NintendoWiFiConnectionMessagename=message connexion wi-fi nintendo
NoButton=bouton non
NoButton2=bouton non 2
NoButtonB=bouton non 3
NoButtonC=bouton non 4
NoButtonD=bouton non 5
NoButtonE=bouton non 6
NoButtonF=bouton non 7
NoButtonG=bouton non 8
NoButtonH=bouton non 9
NorthKoreaFlag=drapeau coree du nord
NullBackgroundTemplate=arriere-plan vide
Number0messagename=message numero 
okmessagename=message ok
PowerStar=etoile de puissance
PowerStarBlack=etoile de puissance noire
PowerStarBlue=etoile de puissance bleue
PowerStarBronze=etoile de puissance bronze
PowerStarBrown=etoile de puissance marron
PowerStarCrazyComet=etoile de puissance du defi de la comete farceuse
PowerStarEmpty=etoile de puissance transparente
PowerStarGreen=etoile de puissance verte
PowerStarGrey=etoile de puissance grise
PowerStarLogoOnWall=logo etoile de puissance sur mur
PowerStarMetallic=etoile de puissance metallique
PowerStarOrange=etoile de puissance orange
PowerStarPink=etoile de puissance rose
PowerStarPurple=etoile de puissance violette
PowerStarRed=etoile de puissance rouge
PowerStarWhiteGolden=etoile de puissance blanche doree
PowerZtar=Ztar(etoile de puissance malefique)
RedButton=bouton rouge
SdCardAnim=carte SD animee
SdCardNoAnim=carte SD non animee
sdmessageA=message SD 0
sdmessageA2ndbodymessagename=message SD 0 corps partie 0
sdmessageA3rdbodymessagename=message SD 0 corps partie finale
sdmessageB=message SD 1
sdmessageC=message SD 2
SecretCourseBackground=arriere-plan course secrete
ShineSprite=eclat brillant
ShineSpriteBlack=eclat brillant noir
ShineSpriteBlue=eclat brillant bleu
ShineSpriteBronze=eclat brillant bronze
ShineSpriteCrazyComet=eclat brillant du defi de la comete farceuse
ShineSpriteEmpty=eclat brillant transparent
ShineSpriteFake=faux eclat brillant
ShineSpriteGreen=eclat brillant vert
ShineSpriteGrey=eclat brillant gris
ShineSpriteMetallic=eclat brillant metallique
ShineSpriteOrange=eclat brillant orange
ShineSpritePink=eclat brillant rose
ShineSpritePurple=eclat brillant violet
ShineSpriteRed=eclat brillant rouge
ShineSpriteWhite=eclat brillant blanc
ShineSpriteWhiteGolden=eclat brillant blanc dore
SilverStar=etoile d'argent
SkyBackground=arriere-plan ciel
SnowBackground=arriere-plan neige
SouthKoreaFlag=drapeau coree du sud
SpaceBackground=arriere-plan espace
SpaghettiKingdomCoins=piece d'or royaume spaghetti
SpainFlag=drapeau espagnol
spotpassmessagename=message Spot Pass
StarCoin=piece etoile
StarCoinEmpty=piece etoile deja prise
streetpassmessagename=message Street Pass
textbox=boite a texte
TickTockClockWorldBackground=arriere-plan monde horloge tic-tac
UnderGroundBackground=arriere-plan metropolitain/sous-sol
VolcanoBackground=arriere-plan volcan
wiiconnect24messagename=message Wii Connect  24
YesButton=bouton oui
YesButtonB=bouton oui 1
YesButtonC=bouton oui 2
YesButtonD=bouton oui 3
YesButtonE=bouton oui 4
YesButtonF=bouton oui 5
YesButtonG=bouton oui 6
YesButtonH=bouton oui 7
YesButtonI=bouton oui 8
YesButtonJ=bouton oui 9
YoshiGrafitty=grafitti yoshi
zpotzassmessagename=message ZpotZass
ztreetzassmessagename=message ZtreetZass
and the list is far to be complete
et la liste est loin d'etre complete





